1111111111
1PC0C0C001
1011101111
1000C000E1
1111111111