1111111111
1PC0C0CA01
1011101111
10A0C000E1
1111111111