111111111111111111111111111111111
1110000000011111011C1111110010001
10P001111100110000000000011010011
100001111100100000100000001000011
10000C111110001100001000000010101
10000111C111001100000000100010101
100001C10001001100010000000010111
100001011C01100110000010000001011
100000000000000000000000010100E11
111111111111111111111111111111111
