11111111111111111111111111
10000000000A11A000000001A1
1C1111C1111C11C1111C1111C1
1C1111C1111C11C1111C1111C1
1C1111C1111C11C1111C1111C1
10A00000000C00C0000000A001
1C1111C1C11111111C1C1111C1
1CCCCCC1CCCC11CCCC1CCCCCC1
111111C111101101111C111111
111111C100000000001C111111
111111C101110011101C111111
1ECCCCC0000AAAAA000CCCCC01
111111C101111111101C111111
111111C100000000001C111111
111111C101111111101C111111
1000A000A00011000A0000A001
1C1111C1111C11C1111C1111C1
1CCC11CCCCCC0PCCCCCC11CCC1
111C11C1C11111111C1C11C111
1CCCCCC1CCCC11CCCC1CCCCCC1
1C111111111C11C111111111C1
1CCCCCCCCCCCCCCCCCCCCCCCC1
11111111111111111111111111
