1111111111111111111111111111111111
1E0000000A00000C00000C000000000001
101A010100100000101001000000010101
1010010010101010001001000000010101
1P000C000C00C0000C0C0000000A0000C1
101A010010101010001001000000010101
1010010010101010001001000000010101
1CA000000C00C000000000C000A00001A1
1111111111111111111111111111111111
