111111111111111111111111111111111111111111111111111111111111111111
1P00000000000000A00000000000000000000000000000000000000000000000C1
1000000000000000000000A0000000000A00000A00000000000000000000000001
100000000000000000000000000000000000000A000000000000000000000000A1
1A0C00000000000000000000000000000000000A00000000000000000000000001
10000000000000000000000000000000A000000000000000000000000000000001
10000000000000000000000000000000E00A00000000000A0000000000A0000001
111111111111111111111111111111111111111111111111111111111111111111